空空草空草空草空草空草空空
空砖空砖空砖空砖空砖空砖空
空砖空砖空砖空砖空砖空砖空
空砖空砖空砖空砖空砖空砖空
空砖空砖空砖空砖空砖空砖空
铁空铁空铁空铁空铁空铁空铁
草空水空空水空空空水空空草
草草水水砖水水砖水水砖草草
铁空水空砖砖砖砖草水砖空铁
空草草草草草草草草草草草空
铁空砖空砖空砖空砖空砖空铁
空空空空空空空空空空空空空
空空空空空空空空空空空空空